nontyphi_nucl_18mers_sam_0_FR	TACCAATTCCGCCACCTTCG	CGAAGGTGGCGGAATTGGTA
nontyphi_nucl_18mers_sam_1_FR	ACTTCTGAGTTCGGCATGGG	CCCATGCCGAACTCAGAAGT
Paratyphi_ABC_18mer_nucl_sam_86_FR	GGACGGTCGCTACATCAACA	CGGTTCGATGTTCATGGTGC
Paratyphi_ABC_18mer_nucl_sam_19_FR	TTTAGCCGTTTCTTGCCTGC	TTTAACCGCCTCCGACAACA
Paratyphi_ABC_18mer_nucl_sam_47_FR	TCACCTTTCTGCCAGGTTCC	GGGTTTAGCGCCCGATTTTG
Paratyphi_ABC_18mer_nucl_sam_91_FR	GAGATCAAGCTGTTGCACGC	TCAAGCTGTACCTGCAGACG
Paratyphi_ABC_18mer_nucl_sam_0_FR	TAAGCCCAGCGAGCATGTAC	GATCTCCTGTAACGCGCCTT
Paratyphi_ABC_18mer_nucl_sam_1_FR	GGCAATATTCAGCTCACGGC	GCAAGCCCTCAATTACAGCG
Paratyphi_ABC_18mer_nucl_sam_2_FR	TCACCCTTCTGAAACGCAGG	ACTTGCTTTGATGCTGCTGC
Paratyphi_ABC_18mer_nucl_sam_3_FR	AGCTCCTGGACATACTGCGA	ATCATTTTTCCCGGCTGGCA
Paratyphi_ABC_18mer_nucl_sam_4_FR	CCACGGGAAAACCCAGAACA	TTGACGTGCGACGAAAATCG
Paratyphi_ABC_18mer_nucl_sam_5_FR	ATCCTGATGGCGGGCTTTAC	TCCATCGCTTCCTGGTAGGA
Paratyphi_ABC_18mer_nucl_sam_6_FR	TCGAAGTCGAGAATCTGCCG	CAGTTTTACGCTCACGCCAC
Paratyphi_ABC_18mer_nucl_sam_7_FR	TCATCCATGCGGACTTCGTC	GGTCAACTACCTGTCCCGTG
Paratyphi_ABC_18mer_nucl_sam_8_FR	ATTAATGGCGTGCTGGTGGA	AGTTTTGCGATTCAAGCCGG
Paratyphi_ABC_18mer_nucl_sam_9_FR	GAGGCGCTGATATTCGACGA	ATCCATCATTCGGCGCAGAT
Paratyphi_ABC_18mer_nucl_sam_10_FR	TCCGGTTGCATTGACCACTT	TAGAGCCAGGGCAGATAGCT
Paratyphi_ABC_18mer_nucl_sam_11_FR	AATGATGTATTGCGCGCTCG	TGGCGGATTAGCGGAAAAGA
Paratyphi_ABC_18mer_nucl_sam_12_FR	GATTCACCCCTGGTTTGGCT	TGGCTGAAGTTGCGACGTAT
Paratyphi_ABC_18mer_nucl_sam_13_FR	GTGACACGCCTGATACTCGG	TATCGCCATATACGCCACGG
Paratyphi_ABC_18mer_nucl_sam_14_FR	GGCATGCATAAAGGCGTCTG	AAGGCGCGAAAGATCTGGAT
Paratyphi_ABC_18mer_nucl_sam_15_FR	ACTTCTTCCAGCACGATGGC	ATGGGAAACGGGCAATGTCA
Paratyphi_ABC_18mer_nucl_sam_16_FR	TACAGCCTGCCAGCATAGTC	CTAACCCTTCGCCGCTGAAA
Paratyphi_ABC_18mer_nucl_sam_17_FR	CGCGATAGTTATTCGTGGCG	GGGATGGCTTTCGCACCTAT
Paratyphi_ABC_18mer_nucl_sam_18_FR	CGAAAGCGCGAATGATCAGC	CGCAGTTTTATCGCCACGTT
Paratyphi_ABC_18mer_nucl_sam_19_FR	TTTAGCCGTTTCTTGCCTGC	TTTAACCGCCTCCGACAACA
Paratyphi_ABC_18mer_nucl_sam_20_FR	GCAGAAACGCCGCAAATTTC	GCACCGATGTGGCGTTAATG
Paratyphi_ABC_18mer_nucl_sam_21_FR	GGTGAAAGAAGTGGTGCTGC	AAGCCCTGTTTCAGCAGCTT
Paratyphi_ABC_18mer_nucl_sam_22_FR	ATTACGCCGGCAATATGGGA	GCCTGCATTTTGGCGTACAG
Paratyphi_ABC_18mer_nucl_sam_23_FR	CGGCCATGAACGTGTCAAAG	CGCGGCGAAGGTAAATTTGA
Paratyphi_ABC_18mer_nucl_sam_24_FR	CGCTGTTTCAGGCATTCGAC	TCATCGCCACGCCTTTCAT
Paratyphi_ABC_18mer_nucl_sam_25_FR	GTTCCGTCGCCTGAACATTG	CCTGTAATCAGCAGGCGACA
Paratyphi_ABC_18mer_nucl_sam_26_FR	TTTTGGTCACGTCAGCTCCA	AAGAGCGCCGTTATATGGGG
Paratyphi_ABC_18mer_nucl_sam_27_FR	TCTTCTCAGGTTCATGCGCA	TTTCGCCAGATCCATACCGT
Paratyphi_ABC_18mer_nucl_sam_28_FR	CAAATTTGATTTGCGCGGCC	GAGTTCGGTTTTATCGGCGC
Paratyphi_ABC_18mer_nucl_sam_29_FR	TTAGGGCCGGGCGAATTAAA	CAAATACTCCTGCAAGCGCG
Paratyphi_ABC_18mer_nucl_sam_30_FR	CAGATGCGGCTCGGTAATGT	GCTGGTCATTCCGCTGTTTG
Paratyphi_ABC_18mer_nucl_sam_31_FR	CGTCTGGTATGCCGCCATAT	GGTTAAATCAGGGGACGGCA
Paratyphi_ABC_18mer_nucl_sam_32_FR	GTTGGCGTGCAGATCGATATC	ATGAACCGTAACGTGCTGTG
Paratyphi_ABC_18mer_nucl_sam_33_FR	GTGCAGCGTCAATAGCGTTT	TTTGAAGAAGCGGCGGAGAT
Paratyphi_ABC_18mer_nucl_sam_34_FR	TTGGCGCGATCACCACTTTA	CTGGACGAAAAGGGCCAACA
Paratyphi_ABC_18mer_nucl_sam_35_FR	GGGACGCATCCTGCACTTTA	AAGAAACGTTGCGCATCACC
Paratyphi_ABC_18mer_nucl_sam_36_FR	CTTCTCTGCTTTTGCCACCG	CTGAACTGGAAGCGGACGT
Paratyphi_ABC_18mer_nucl_sam_37_FR	GATCTGGTGATTGCCGGTGA	CAGCAGCGTGATTTGCATCA
Paratyphi_ABC_18mer_nucl_sam_38_FR	CTGGCAAAAGGCGATCGAAG	ACACCCGGGCGCTATTTTTA
Paratyphi_ABC_18mer_nucl_sam_39_FR	TCGCTGTGAAGATGCAGTGT	CCCCAGTCAAACTACCCACC
Paratyphi_ABC_18mer_nucl_sam_40_FR	GAGTTTGGCGCGGTGATTTT	CCTACCACACGTCGACCAAA
Paratyphi_ABC_18mer_nucl_sam_41_FR	TATTTTCCGTGGTGGCGTCA	ATGTCGGCATCCAGAAACGT
Paratyphi_ABC_18mer_nucl_sam_42_FR	GGAAGGTCTGTTCCGTCAGA	GAACGGGATCATCGGCAGAT
Paratyphi_ABC_18mer_nucl_sam_43_FR	GGAAGCGCTGACCAAAATCC	TTCTCTTCCAGACGCACCAG
Paratyphi_ABC_18mer_nucl_sam_44_FR	CTGCAGGCAGTTCAGGAAGA	GGACTGGCTTGAGCATGTCT
Paratyphi_ABC_18mer_nucl_sam_45_FR	GTTCATGTCGTTGGCGTGC	ATGAACCGTAACGTGCTGTG
Paratyphi_ABC_18mer_nucl_sam_46_FR	ACCAACGTACGGCGATGTAG	TATTCTGGTCGCGGATGAGC
Paratyphi_ABC_18mer_nucl_sam_47_FR	TCACCTTTCTGCCAGGTTCC	GGGTTTAGCGCCCGATTTTG
Paratyphi_ABC_18mer_nucl_sam_48_FR	GGCAGAAACGCATATTCGGC	TGACGTTGATCTTGACCGCA
Paratyphi_ABC_18mer_nucl_sam_49_FR	AAGACCTGCTGCAACTGACA	CCCGCTGATCGAAAAACACC
Paratyphi_ABC_18mer_nucl_sam_50_FR	GTGTTTGTCTGAACGTCGGC	CCCAGACCGTTGACCACTTT
Paratyphi_ABC_18mer_nucl_sam_51_FR	ACGCACCTTAATCCTGACGT	GGCGATCCCAACCATCGTAT
Paratyphi_ABC_18mer_nucl_sam_52_FR	TGCTGGAAGAAATCGTTGCC	GGGCAGTATCGGCGGC
Paratyphi_ABC_18mer_nucl_sam_53_FR	ACAACGAGAAACCGACCAGT	GGTCCGTCATGCCGATGTAT
Paratyphi_ABC_18mer_nucl_sam_54_FR	GCGTCTGCGTGGATAGCTAT	TGAGTTTCTCCCGCCAGATG
Paratyphi_ABC_18mer_nucl_sam_55_FR	TTGATGCCTGCGATGCCTTA	TCGACTCATCCAGCATCGTG
Paratyphi_ABC_18mer_nucl_sam_56_FR	CGTATCCAGCGCGGTTTCTA	GTCAGGATGCTGGAAAACGC
Paratyphi_ABC_18mer_nucl_sam_57_FR	TTCCTGGCTGCAACTTACGG	ATCGTAACGACTGGGGCTTC
Paratyphi_ABC_18mer_nucl_sam_58_FR	CTGTTTCTTACGCGCAGACG	CGGTCAGGATTATCCAGCCC
Paratyphi_ABC_18mer_nucl_sam_59_FR	CCCGGCGGAAGTTGAGATAG	GGATGCAGCGTTGGTTTCTG
Paratyphi_ABC_18mer_nucl_sam_60_FR	GCCCAGTGAGCAATAGGGAA	CCTGGCTACTGTGGATTGCA
Paratyphi_ABC_18mer_nucl_sam_61_FR	GTAATGTAACCGCCCGGGAA	TGGCGAACCCGATCAATCTC
Paratyphi_ABC_18mer_nucl_sam_62_FR	GCGGATACAAAGCCAACGAA	CGTAGATTTCCCGGGCGTTA
Paratyphi_ABC_18mer_nucl_sam_63_FR	TCATCGCCAGCACTTTCTCT	CATTCTGCGCGGCGATAAAC
Paratyphi_ABC_18mer_nucl_sam_64_FR	TGATCGGCTTGCCGCTTATT	GAAGTTCACGCATCCGGGA
Paratyphi_ABC_18mer_nucl_sam_65_FR	ATAAACATCCCGGTGCGTCA	GCCATAAAACAGGCGGCAG
Paratyphi_ABC_18mer_nucl_sam_66_FR	CGCTTTTCTTTGGCGCGTAT	CAGCGAGTTCTGGTACGGTT
Paratyphi_ABC_18mer_nucl_sam_67_FR	TCTCTTCGTTCAGCCAGCTT	AGCCCATTGCCTTCTTGAGA
Paratyphi_ABC_18mer_nucl_sam_68_FR	CGGCGTTTGTCATCGTCAAG	CCGTATCGCCGAGGAGAAAG
Paratyphi_ABC_18mer_nucl_sam_69_FR	TCGGCCATTAGGTAAAGCGA	GCACCAGCGCAGATAGTCAT
Paratyphi_ABC_18mer_nucl_sam_70_FR	GAGTAGCTCCCGGGCATTAC	CATGTAGCGATCCTGCCTGT
Paratyphi_ABC_18mer_nucl_sam_71_FR	TATTGTCGACGTGAACCCGG	GATTACCAAACGTCAGCGCC
Paratyphi_ABC_18mer_nucl_sam_72_FR	GCCGTAAGAGTGACGCTGAG	CCTAACGCCTGCATAAACGC
Paratyphi_ABC_18mer_nucl_sam_73_FR	CGATGGGCTTGCTGACAAAC	CATCAAAGGCGCGGATATCG
Paratyphi_ABC_18mer_nucl_sam_74_FR	CGATTCCCTGTCGAAAAGCG	AACATGCATCCGACGATCGT
Paratyphi_ABC_18mer_nucl_sam_75_FR	TGCTGAGTGCGCTGCATATA	ACCGGTCCGTGATGAAAGTC
Paratyphi_ABC_18mer_nucl_sam_76_FR	GCAGTAGACAAAGCGCAAGG	TTTGCCTTGCATGTGTCGTG
Paratyphi_ABC_18mer_nucl_sam_77_FR	GCAAGATTACGGGGCGGATA	CGGAAGGGATACGCATCAGG
Paratyphi_ABC_18mer_nucl_sam_78_FR	GCGGACCGGGAAAAAGTAGA	GCCGCCATGTTGATATCGTG
Paratyphi_ABC_18mer_nucl_sam_79_FR	GGTACAACCAGCGGCAAAAG	CGGATGAGCGGCTTGTTTAG
Paratyphi_ABC_18mer_nucl_sam_80_FR	CTTCAGGCATTGGGATTGCG	GGCAAGAATGAAGGTTGCGG
Paratyphi_ABC_18mer_nucl_sam_81_FR	ACAGGCTAACCCACAGTACG	AGCGTGTTTCTTCAGGTGGG
Paratyphi_ABC_18mer_nucl_sam_82_FR	ACTCCGCCGAACATATGTCG	TGCCTGGGTCAGCATTTTCA
Paratyphi_ABC_18mer_nucl_sam_83_FR	GGCCCAGTCGAAGAACTTCA	AGCTTCTCTAATGCGGCGAA
Paratyphi_ABC_18mer_nucl_sam_84_FR	CATTACGCCCATTATGCCGC	GGTGGGAATTGCTTACCCGA
Paratyphi_ABC_18mer_nucl_sam_85_FR	AAATCGCCGCGCCTAAAAAC	TCGCCAGCAAATTACCTGGG
Paratyphi_ABC_18mer_nucl_sam_86_FR	GGACGGTCGCTACATCAACA	CGGTTCGATGTTCATGGTGC
Paratyphi_ABC_18mer_nucl_sam_87_FR	ACAGAGGCGGTGTATGTTGG	AAACCAGATCGGGCTGAGTG
Paratyphi_ABC_18mer_nucl_sam_88_FR	GTTGGCTATGCGATCAGGGT	CCGCGGTTAATGCCAATCAC
Paratyphi_ABC_18mer_nucl_sam_89_FR	TTACCGAACGGCGAGTGATT	GGAACTGAAACAGGGCGGTA
Paratyphi_ABC_18mer_nucl_sam_90_FR	CGGCAATACTCCAGGTAGCA	TGTGGCGCTGTCAGATCAAT
Paratyphi_ABC_18mer_nucl_sam_91_FR	GAGATCAAGCTGTTGCACGC	TCAAGCTGTACCTGCAGACG
Paratyphi_ABC_18mer_nucl_sam_92_FR	TCAACGGAACCGACGACAAT	TTGATGAAGAGACCCGCGAC
Paratyphi_ABC_18mer_nucl_sam_93_FR	GCAAAACGCTACGATCTGCC	GCCGACGCCGATTTTATAGC
Paratyphi_ABC_18mer_nucl_sam_94_FR	TCCGCACCATACCAGTAACG	CGTCTGCGCGTAAGAAACAG
Paratyphi_ABC_18mer_nucl_sam_95_FR	TGGCCACAGTTGCACTCTTT	ACCATTTTGATGCCCATCGC
Paratyphi_ABC_18mer_nucl_sam_96_FR	TTTAGCGCGCTGAGTTATGC	GCGTTGCCGTCCAGCATATA
Paratyphi_ABC_18mer_nucl_sam_97_FR	GCGGTTAAAATAGCAGGCGG	TTCTCGGTGCTCTTTACGGG
Paratyphi_ABC_18mer_nucl_sam_98_FR	CACCGCATCCATCACATCCT	CTTTATCCCGATGCCCTGCT
Paratyphi_ABC_18mer_nucl_sam_99_FR	GTGTCGTTATGGAAGGGCGA	ACTCGCCCCGTTTGAAATCT
typhi_nucl_18mer_mapping_sam_0_FR	TAACGGGCGCGAATATTGGT	GCCACGTGAAGGTATCGTCA
typhi_nucl_18mer_mapping_sam_1_FR	CCGATCCAGAGGCTTATCAGG	CCTGATTTTTCATCGCCCGC
typhi_nucl_18mer_mapping_sam_2_FR	GCAGACGAATAATGTGACGCC	CTTTTGCAGTTGCCAGACCG
typhi_nucl_18mer_mapping_sam_3_FR	GCTGATCGGCTGGAAAGAGT	TTCACTGCGAACTGGACGTT
typhi_nucl_18mer_mapping_sam_4_FR	ATTGTTGAAGTGGCGCGTTC	CCGGCAACCGCTTTTATTCC
typhi_nucl_18mer_mapping_sam_5_FR	ATGGTCAGCTTCGCGTAG	ATGGGGCTGGATGACGG
typhi_nucl_18mer_mapping_sam_6_FR	CGTCTGAATCTGGCCGATGA	AACACCATTGGTTGAACCGC
typhi_nucl_18mer_mapping_sam_7_FR	GAGGATTCGAACCTCCGACC	AGGTTCGAATCCTCCCGGA
typhi_nucl_18mer_mapping_sam_8_FR	TGGGCGCGAAAACTATGTGA	ATGGAAAACCCCCAGCTAGG
typhi_nucl_18mer_mapping_sam_9_FR	TCTGCTGCTCAATAGACGCC	GTATGAAGTCCGCATGGCCT
typhi_nucl_18mer_mapping_sam_10_FR	GCTGGCGGGGTGATCTTT	GCAGCGTCAGCCAGTTAATC
typhi_nucl_18mer_mapping_sam_11_FR	CCAGGGAATGCCGGTATCAA	GCAAGGTGTGCGAGTTCAAG
typhi_nucl_18mer_mapping_sam_12_FR	TACGGCTCGAAACCATTGGT	AGGCGGCTATGGTGAATACG
typhi_nucl_18mer_mapping_sam_13_FR	TTCAACTCCTGGCTTTCCGG	GCTAACCCGGAGTACAGCTC
typhi_nucl_18mer_mapping_sam_14_FR	GGGCGCGAAAACTATGTG	TGACGATCCTGCCATAACCG
typhi_nucl_18mer_mapping_sam_15_FR	TGGATCTCTCGCCAACCAAC	GGTTTCGACGCCGATTTCAC
typhi_nucl_18mer_mapping_sam_16_FR	GTTCAGCTTCCAGGGACACC	CCAGAATAACGCGGTAGCCT
typhi_nucl_18mer_mapping_sam_17_FR	TCCCGAGAACTGGAAAGAGC	GAGCCACATGGTTTCCGGTA
typhi_nucl_18mer_mapping_sam_18_FR	GGCCTTCTCCAATGGTTCGA	TTCAATGACCAGCGATCCCC
typhi_nucl_18mer_mapping_sam_19_FR	TTGATGCCGGGAAAACGTCT	CCGGCATTACCAGCAAATCG
typhi_nucl_18mer_mapping_sam_20_FR	CGGCGGACGCTAAGAAGAAA	TCGCATCATACAGACGGCTC
typhi_nucl_18mer_mapping_sam_21_FR	AAACGTCACCGGCAAAAAGT	ACGCTTACCTTGTCAACGGA
typhi_nucl_18mer_mapping_sam_22_FR	CGGGATCGCTGGTGGTAATT	GGGCTAAAACACTGGCAACG
typhi_nucl_18mer_mapping_sam_23_FR	CACTCATCTTCGGCGGGATC	GCACACCCGATGGAACTGTA
typhi_nucl_18mer_mapping_sam_24_FR	AGCTCCGCCTCAGGATGTAA	AGATCGTATGCGCCTGTT
typhi_nucl_18mer_mapping_sam_25_FR	ACCAGAATCTGCTGATGGCC	CCACGTTTCACCGTCCACAT
typhi_nucl_18mer_mapping_sam_26_FR	GCTACGGCGTTTCACTTCTG	GTAGAGCGCACCCTTGGTAA
typhi_nucl_18mer_mapping_sam_27_FR	TGATACCACAGCCAGGCAAG	TGATGTCAGATTTCGGGGGC
typhi_nucl_18mer_mapping_sam_28_FR	GCCGGTGTTATTGCTGGATG	GACAACCTGCCGTTTTCCAG
typhi_nucl_18mer_mapping_sam_29_FR	GGTCAGTATCCCCAGAAGCG	TGGTGTATGCCCAAGAGCTG
typhi_nucl_18mer_mapping_sam_30_FR	GGGTCGTTAGCTCAGTTGGT	CTGAGCTAACGACCCCTTGG
typhi_nucl_18mer_mapping_sam_31_FR	CTCATCTTCGGCGGGATCTC	GCACACCCGATGGAACTGTA
typhi_nucl_18mer_mapping_sam_32_FR	TTCAGGTATTTTGTGGTGCG	AGAAATGTGGACGGTGAAACG
typhi_nucl_18mer_mapping_sam_33_FR	ACGTCACCGGCAAAAAGTTG	ACGCTTACCTTGTCAACGGA
typhi_nucl_18mer_mapping_sam_34_FR	CGGGATCTCCAGAAGCATGT	TCACATAGTTTTCGCGCCCA
typhi_nucl_18mer_mapping_sam_35_FR	AATCCGGCCTTCTCCAATGG	TTCAATGACCAGCGATCCCC
typhi_nucl_18mer_mapping_sam_36_FR	CTCTGCACCAGAACTCCCTG	AGTTTTCGCGCCCAAATACC
typhi_nucl_18mer_mapping_sam_37_FR	CGGTCAGGGAAGACAGTTCC	GTCACCCGTAAATTGCTGCC
typhi_nucl_18mer_mapping_sam_38_FR	GCACCAGCTTGAAGAGGATA	CCATAAAGCGAATGTGCCGG
typhi_nucl_18mer_mapping_sam_39_FR	CCACCGCCCACATGTGC	GTTCTGGGATCTGCAGGACC
typhi_nucl_18mer_mapping_sam_40_FR	TGGTGGTGTTGGTGGCAATA	ATCTGAGCAACTCCGTCACC
typhi_nucl_18mer_mapping_sam_41_FR	AGCCAGTCGTCATCTGCAAT	GGTGTATGTAGGTCGCTGGG
typhi_nucl_18mer_mapping_sam_42_FR	CCTACTGCCCTACGCTTCTC	GGTCTGGCAACTGCAAAAGT
typhi_nucl_18mer_mapping_sam_43_FR	GAGATCCCGCCGAAGATGAG	GCCGTATTCTTACCCACCGT
typhi_nucl_18mer_mapping_sam_44_FR	GAAGCTAGCGCGTCTACCAA	CGTAGCTCAGCTGGATAGAG
typhi_nucl_18mer_mapping_sam_45_FR	GCGAAATTGGTGGTGGTTCC	GCACCGGCGTGATTATTTCC
typhi_nucl_18mer_mapping_sam_46_FR	GCAGAGGAACAAACGATCGC	AGAAACATCACCGACGACCC
typhi_nucl_18mer_mapping_sam_47_FR	GAAGCGGAATGTTGTGCAGA	GCCGTATTCTTACCCACCGT
typhi_nucl_18mer_mapping_sam_48_FR	GATTGGAGACATCGCAAGCG	TGATTACTACCTCGCGGGGA
typhi_nucl_18mer_mapping_sam_49_FR	GGGATCGATAATTGCTCACCC	AGTTTCATGGGATATCTGAAGGGT
typhi_nucl_18mer_mapping_sam_50_FR	ACTGACGGGTAAATGGCAGG	TTCGAGCGTCTGTCAACCAA
typhi_nucl_18mer_mapping_sam_51_FR	CTCTGCACCAGAACTCCCTG	CGTACGAATTCTGGAAGCGG
typhi_nucl_18mer_mapping_sam_52_FR	ACCGCTGGATGATTAACCCG	CCCCATTCGTTCTCGGTCAT
typhi_nucl_18mer_mapping_sam_53_FR	TACGCCGTTTTCCAGATCGG	CGAGCTGGACCCAATGATCA
typhi_nucl_18mer_mapping_sam_54_FR	GCTACGGCTCGAAACCATTG	AGGCGGCTATGGTGAATACG
typhi_nucl_18mer_mapping_sam_55_FR	ACGGGATCGATAATTGCTCACC	AGTTTCATGGGATATCTGAAGGGT
typhi_nucl_18mer_mapping_sam_56_FR	AGTGGCGAACCTCCTGATTG	TACTCGAGGCCGGAGAATCA
typhi_nucl_18mer_mapping_sam_57_FR	ATGATAGAAGGTCAGGCGCC	AGGCGGCTATGGTGAATACG
typhi_nucl_18mer_mapping_sam_58_FR	ATACGGGACCAGCCATCAA	AGGAATAAGACAAATGAGCACAGC
typhi_nucl_18mer_mapping_sam_59_FR	GCGGAATGTTGTGCAGATCA	GCCGTATTCTTACCCACCGT
typhi_nucl_18mer_mapping_sam_60_FR	TGCCGTGTTGGTTGAGGTAA	CAAGAACCAGCGTTGTACCG
typhi_nucl_18mer_mapping_sam_61_FR	GTATCTACCCGGCCGTTGAC	AGGAAGCGCTGGATCTTACG
typhi_nucl_18mer_mapping_sam_62_FR	AGAAGGCGCATGGTATGACC	TTGTAGTCCTTGCAGGCCAG
typhi_nucl_18mer_mapping_sam_63_FR	GGAGCAGAACGACAGCCTG	ACAACTTTTTGCCGGTGACG
typhi_nucl_18mer_mapping_sam_64_FR	TGCTGGCTGACCTTATCGTC	GGGACAAGAGCCACATGGTT
typhi_nucl_18mer_mapping_sam_65_FR	TCAGTATGACACGGTGGACG	TCCCATAGCTGGACGGTCTG
typhi_nucl_18mer_mapping_sam_66_FR	CGTCACCGGCAAAAAGTTGT	ACGCTTACCTTGTCAACGGA
typhi_nucl_18mer_mapping_sam_67_FR	TCAATTGGTCGCAGGTTCGA	CTGAGCTAACGACCCCTTGG
typhi_nucl_18mer_mapping_sam_68_FR	TGACGATAAGGTCAGCCAGC	TGAGCATCACGATCCTGCAT
typhi_nucl_18mer_mapping_sam_69_FR	CAGGAGCAGAACGACAGCC	ACAACTTTTTGCCGGTGACG
typhi_nucl_18mer_mapping_sam_70_FR	ATCGTATGCGCCTGTTAGGG	CCTGGCAGTTGCTACAGTGT
typhi_nucl_18mer_mapping_sam_71_FR	TTCCAGGTGTAATCGCAGTG	ACTGTCACTCCTGTGGGGTA
typhi_nucl_18mer_mapping_sam_72_FR	ATCGTCTTCCCCAACCCTCA	GTGGCCGGATGGAATACCTG
typhi_nucl_18mer_mapping_sam_73_FR	GGCATCCATTAGCGTCATGC	AACGAATGGGGAATGTCGGT
typhi_nucl_18mer_mapping_sam_74_FR	CTTTTGCAGTTGCCAGACCG	TGACGGAAGGGGATGAGGAT
typhi_nucl_18mer_mapping_sam_75_FR	GACATTATCAGCCACCGCCG	TTCGTTAAACAGTGCGTGCA
typhi_nucl_18mer_mapping_sam_76_FR	TAGCGCGTCTACCAATTCCG	AACCACTAGAATGCGCCTCC
typhi_nucl_18mer_mapping_sam_77_FR	GCTGCTCAATAGACGCCAGA	GTATGAAGTCCGCATGGCCT
typhi_nucl_18mer_mapping_sam_78_FR	CGCATCATTATGGCCGATCC	TGATTTTTCATCGCCCGCTG
typhi_nucl_18mer_mapping_sam_79_FR	ATCCACCAGAATAAAGGCCG	GCAGTATGATCATGCTGGCG
typhi_nucl_18mer_mapping_sam_80_FR	GGAGATCCCGCCGAAGATG	GCCGTATTCTTACCCACCGT
typhi_nucl_18mer_mapping_sam_81_FR	TGTAACCACTGCGAAGACCC	GTTCGTCTATCGGGCCGAAA
typhi_nucl_18mer_mapping_sam_82_FR	CGGGTGGTACTATGACGCAA	AAACTGGCAGGGTCGAGTTT
typhi_nucl_18mer_mapping_sam_83_FR	AGATCGGTTTATCCCCGCTG	CGCCAGCGGGGATAAACC
typhi_nucl_18mer_mapping_sam_84_FR	TGTCGATAACTGAACGGCGG	TTCCCGCTGGTCAACAAAGA
typhi_nucl_18mer_mapping_sam_85_FR	CGTCTTCCCCAACCCTCATT	GTGGCCGGATGGAATACCTG
typhi_nucl_18mer_mapping_sam_86_FR	GTCGATTTTGCCGCAGTCAA	AAGACCTCGCCGACAAACAA
typhi_nucl_18mer_mapping_sam_87_FR	CTGCCTACTGCCCTACGC	ATGGAAAACCCCCAGCTAGG
typhi_nucl_18mer_mapping_sam_88_FR	ACAACGTGACCTATATCGGCAT	GCGGTGGCTGATAATGTCGT
typhi_nucl_18mer_mapping_sam_89_FR	GGAAGCGGAATGTTGTGCAG	CTCTGCACCAGAACTCCCTG
typhi_nucl_18mer_mapping_sam_90_FR	AATTTTTGTGGGATGGCGGC	CGCGAGTGGGATAGGTGATC
typhi_nucl_18mer_mapping_sam_91_FR	GCATCAGAAAAACCTCCGGC	CATTAAAGCTCGCCGTTCCG
typhi_nucl_18mer_mapping_sam_92_FR	TTGTTTGTCGGCGAGGTCTT	ATGTCACCGCGTCCATTTCT
typhi_nucl_18mer_mapping_sam_93_FR	GGCGGACGCTAAGAAGAAAG	TCGCATCATACAGACGGCTC
typhi_nucl_18mer_mapping_sam_94_FR	GCTGGCTGACCTTATCGTCA	GGGACAAGAGCCACATGGTT
typhi_nucl_18mer_mapping_sam_95_FR	GCCGAGTAATCCGTAGCCAA	CCCATGCCGAACTCAGAAGT
typhi_nucl_18mer_mapping_sam_96_FR	ACAGGGAGTTCTGGTGCAGA	CCCTAACAGGCGCATACGAT
typhi_nucl_18mer_mapping_sam_97_FR	ATCGATACGCGCAGTGCTAT	TCACCTGATTTCCGCTAGCG
typhi_nucl_18mer_mapping_sam_98_FR	GGAAGCGGAATGTTGTGCAG	GCCGTATTCTTACCCACCGT
typhi_nucl_18mer_mapping_sam_99_FR	TCCGTTGACAAGGTAAGCGT	CCCTCGTTGTTACACCGCTT
